cd  	 --> Change the current directory
pwd   --> Display the full path of current working directory
ls    --> List the contents of the current directory
cd ..  ---> Navigates to the parent directory
cd -   ---> Navigates to the home directory
mkdir  --> Create a new directory
cp [source] [destination]  --> Copies files or directory
mv [source] [destination]  --> moves or rename files or directory
touch --> Create an empty files.
cat [file-name]  ---> Display the contents of file
less 	---> Display the contents of file page by page
head 	---> Display first few lines of a file
tail 	---> Display the last few lines of a file
uname   --> Display system information
whoami   ---> Display the current username
ps    ---> Lists currently running process
top    ---> Display a dynamic, real -time view of running processs
df   ---> Display disk space usage
du    ---> Display disk usage of files and directories   
grep  [partten] [file-name]  ----> Searches for a specific partten in a file
sort [file-name]  ---> sorts the lines of a file
wc [file-name] -- Count the number of lines, words and characters in a file.
history   ----> 	Shows the last N commands
history -c  ----> Clears the command history.
history -d N   ----> Deletes the command at line number N.
chmod  ---> 4.Read , 2. write 1.Execute
file  ---> Determines the file type.
ln   ---->
cal  ----> Displays a calendar. 
ip ----> manage and display networking information
nslookup  [hostname or IP address] ---> is a network utility used to query DNS (Domain Name System) records to find the IP address 
zip  ---->  Compresses files into a zip archive.
wget ---> Downloads files from the internet.
tar  ---> Used for creating and extracting archive files.
find  ---> Searches for files and directories based on various criteria.
clear  ----> Clears the terminal screen.
curl    ----> Transfers data with URLs.
zip   ----> Compresses files into a zip archive.
unzip   ----> Extracts files from a zip archive.
chown  ---> Changes the owner of a file or directory.
echo  ---> display a line of text or variables to the terminal. 
